11111111111111111111111111111111111
1E0000000000000000000C0000000000011
100001010010000C1010010000000101011
10000100101010100010010000000100001
100P0000C0000C00000000000000000CC11
11111111111111111111111111111111111