11111111111111111111111111111111111
1E0000000000000000000C0000000000011
101001010010000C1010010000000101011
10000100101010100010010000000101011
10P00000C000C0000000000000000000C11
11111111111111111111111111111111111