11111111111111111111111111111111111
100010000000000000000C0000000000011
100010010010000C1010010000000101011
10001000101010100010010000000100001
100PEC00C0000C00000000000000000CC11
11111111111111111111111111111111111